1111111111111
1000000100011
1000000000011
1111101111111
    100111111
    100100001
    100000001
    100100001
    100111111
    100111111
    100111111
    100111111
    100111111
    100111111
    100111111
    100111111
    100111111
    111111111