11111111111
10000000001
10010001111
10000000001
11111000001
10000000001
11111111111