1111111111111111111111
1000000000000000000001
1000001110000111100001
1000001000000100100001
1000001000000100000001
1000001001100100000001
1000001000100000000001
1000000000100011110001
1000000000000000010001
1000001111000000010001
1000000000000000000001
1111111111111111111111
